22 1 50 15 8 36 43 29 
9 37 2 50 23 16 44 30 
45 17 50 3 38 31 24 10 
4 50 11 39 18 32 46 25 
19 40 50 47 33 26 5 12 
20 13 41 6 27 34 48 50 
49 28 50 21 35 42 14 7 
44 32 14 26 1 38 51 20 
51 8 45 33 2 39 27 21 
3 9 34 40 28 15 51 46 
41 51 16 35 22 47 10 4 
5 23 48 17 51 29 11 42 
30 49 12 24 18 6 51 36 
19 7 25 43 37 51 31 13 
40 13 52 18 1 23 45 35 
24 14 46 29 52 19 2 41 
25 42 30 3 8 52 47 20 
52 31 4 48 26 9 36 21 
37 10 52 49 15 32 27 5 
6 16 43 38 28 33 11 52 
22 52 39 12 17 44 34 7 
16 42 27 1 46 53 12 31 
36 47 32 2 53 28 17 13 
18 33 3 37 53 48 14 22 
8 38 4 53 23 49 19 34 
5 35 53 39 24 9 20 43 
21 53 29 40 44 6 10 25 
45 26 11 41 15 30 53 7 
34 47 21 11 37 24 1 54 
15 12 38 35 54 25 48 2 
13 54 3 39 26 29 16 49 
30 14 27 40 43 54 17 4 
18 5 54 28 31 8 41 44 
32 9 6 19 45 42 54 22 
7 20 54 23 36 33 46 10 
28 48 1 10 19 30 39 55 
55 2 22 31 40 11 49 20 
21 3 55 41 32 12 23 43 
42 4 13 44 15 55 24 33 
55 14 16 34 36 5 25 45 
46 26 6 17 8 37 55 35 
18 38 27 9 7 55 47 29 
56 9 41 17 49 33 1 25 
42 26 56 18 43 2 10 34 
56 35 27 11 3 44 36 19 
45 12 28 56 29 20 4 37 
30 21 13 5 38 56 22 46 
56 6 31 39 23 15 14 47 
56 32 40 7 48 8 16 24 
3 5 7 1 2 4 57 6 
13 10 11 8 9 12 57 14 
21 19 17 57 20 18 16 15 
28 23 57 26 27 24 22 25 
33 57 31 29 35 34 32 30 
36 38 57 37 41 40 42 39 
45 44 57 43 48 46 49 47 
56 50 53 51 55 57 52 54 
